23 23
10 3 3 3 3 3 3 3 3 3 3 14 3 3 3 3 3 3 3 3 3 3 9 
4 0 0 0 0 0 0 0 0 0 0 4 0 0 0 0 0 0 0 0 0 0 4 
4 0 10 3 9 0 10 3 3 9 0 4 0 10 3 3 9 0 10 3 9 0 4 
4 0 4 0 4 0 4 0 0 4 0 4 0 4 0 0 4 0 4 0 4 0 4 
4 0 7 3 8 0 7 3 3 8 0 6 0 7 3 3 8 0 7 3 8 0 4 
4 0 0 0 0 0 0 0 0 0 0 0 0 0 0 0 0 0 0 0 0 0 4 
4 0 1 3 2 0 5 0 1 3 3 14 3 3 1 0 5 0 1 3 2 0 4 
4 0 0 0 0 0 4 0 0 0 0 4 0 0 0 0 4 0 0 0 0 0 4 
7 3 3 3 9 0 11 3 3 2 0 6 0 1 3 3 13 0 10 3 3 3 8 
0 0 0 0 4 0 4 0 0 0 0 4 0 0 0 0 0 0 4 0 0 0 0 
10 3 3 3 8 0 6 0 10 3 3 3 3 3 9 0 6 0 7 3 3 3 9 
4 0 0 0 0 0 0 0 4 0 0 0 0 0 4 0 0 0 0 0 0 0 4 
7 3 3 3 9 0 5 0 7 3 3 3 3 3 8 0 5 0 10 3 3 3 8 
0 0 0 0 4 0 4 0 0 0 0 4 0 0 0 0 0 0 4 0 0 0 0 
10 3 3 3 8 0 6 0 1 3 3 14 3 3 2 0 6 0 7 3 3 3 9
4 0 0 0 0 0 0 0 0 0 0 4 0 0 0 0 0 0 0 0 0 0 4 
4 0 1 3 9 0 1 3 3 2 0 6 0 1 3 3 2 0 10 3 2 0 4 
4 0 0 0 0 0 4 0 0 0 0 4 0 0 0 0 4 0 0 0 0 0 4 
4 0 1 3 3 3 12 3 3 2 0 6 0 1 3 3 12 3 3 3 2 3 11
4 0 0 0 0 0 0 0 0 0 0 0 0 0 0 0 0 0 0 0 0 0 4 
7 3 3 3 3 3 3 3 3 3 3 9 3 3 3 3 3 3 3 3 3 3 9 